111111111111111111131
100010000000100000001
111010111010111111101
100010100010000000001
101111101111111111101
101000101000100000001
101010101010101111111
100010101010100010001
111110101110111011101
100010001000001000101
101011111011101110101
101000000010000010101
101011111111111010101
101010000000001010101
111010111111101010101
100010100000101010101
101110111011101110101
101000001000101000101
101011101110101011101
120010000000100000001
111111111111111111111