11111111111
12000000001
10000000001
10000000001
10000300001
11111111111