11111111111
12100000001
10101111101
10001000001
11111011111
10001010001
10101010101
10101010101
10111010101 
10000003101
11111111111