1111111
1200001
1000001
1000001
1000001
1000003
1111111